input	reference	prediction
#qum# La esposa de don Jesus solo utiliza buena leña	wu rxqiil taʼ xuux xaq utz laj siʼ kchuknik chre	qum ri rkaʼyʼaqbʼik
#qum# Todo la arveja se	Njeel ri xkarawaʼn xpochʼik rech chenim xchaqʼjik	qum ri ajkʼal riij riij xtzʼalxik ri rxbʼal
#qum# En nuestro pueblo ya no se usa nuestro idioma	Pri qtinmit qal chik kchkunsxik ri qyolbʼaal	qum, i'm not talking in my neighborhood
#qum# El estudiante está aprendiendo como	Ri ajtijnel tjin kirtijuuj c hemo rchkunsxik ri suʼ	qumxik ri rkaʼy ri rkʼalxik ri rkaʼy
#qum# La mujer estaba abrazada por su marido	Ri ixoq tzʼulmaj rum ri rchjiil	qum. The woman was hugged by her husband.
#qum# Mañana van a sembrar con don Francisco	Rukʼ taʼ Francisco chwaʼq xtbʼanik awaʼn	qum ri xbʼaal ri xbʼanik
#qum# Alrededor de la casa hay un cerco	Chwoch ri jaay kʼolik jun tzʼapiibʼ	qumx xqʼeʼn xqʼeʼn
#qum# Ataq	Los jóvene s todos los días juegan en el campo Perjuicio	qum xeʼ ri rqʼabʼ
#qum# Cuando murió mi mamá me quedé en la tristeza	Ataq xchupik ri nchuch xinkanajken pri bʼiis	qum. Mommy died, I cried.
#qum# la mujer se murió de la matriz	Ri ixoq xchupik rum wu rchuch rkʼuʼx	qum.
#qum# Entre tres días nos encontramos para platicar del	Oxej xtqriq qiibʼ chi ryolik ri chaak	qumilike. We met in three days so that
#qum# A los niños no es bueno enseñarles a	Chke ri ajkʼ a lobʼ qal utz xtnaqʼsxik ri elqʼneem	qum, a) a) a) a) a) a) a) a) a) a) a) a) b) a) a) a)
#qum# La hoja de aliso es bueno para la broza	Ri rxaq limobʼ utz kchuknik chi ri qʼyees	qumabur. . . . . . . . . . . . . . . . . . . . . . . . . . . . . . . . . . . . . . . . . . . . . . . . . . . . . . . . . . . . . . . . . . . . . . . . . . . . . . . . . . . . . . . . . . . . . . . . . . . . . . . . . . . . . . . . . . . . . . . . . . . . . . . . . . . . . . . . . . . . . . . . . . . . . . . . . . . . . . . . . . . . . . . . . . . . . . . . . . . . . . . . . . . . . . . . . . . .
#qum# El caballo se cayó por mucha carga	Ri keej xtzaqik rum wu xaq et rchim	qum, i.e.
#qum# El bebé resbaló en la cascara de la fruta	Ri ajkʼal kjilpji k pri riij loʼn	qum: The baby is dragged in the fruit basket.
#qum# El señor le dejo toda la tierra a su nieto	Ri tatyoox xyaʼken njeel ri uleew chu ri rmon	qum riʼul ri chʼoʼn chiʼ
#qum# Los zapatos de la señorita les quedo flojo Jaula	Wu xjabʼ koʼl xiʼ kanajken pirqan wu aliit	qum wuʼl ri chʼoʼj
#qum# La comadreja se terminó de comer las gallinas	Wu saqtbʼiin mixeʼrkʼis ri akʼ c htijik	qum!
#qum# Cuatro mesas grandes servirán para comer	Kji bʼ nmaq meex xkiʼchuknik rech weʼbʼal	qum wu ryaʼj ri rbʼanik
#qum# Todos los lapiceros ya están divididos a los niños	Njeel ri tzʼibʼbʼal jachmaj chik chke ri ajkʼalobʼ	qum, i.e. all the haircuts have already been distributed among the children.
#qum# La mata de aguacate se está secando por el	Ri rqan ooj tjin rchiqik rum wu tzrabʼ	qum ri rkaʼyxik ri rchʼiij
#qum# Cuando bajamos a la orilla del río es muy	Ataq kojqajbʼik chchiʼ ri yaʼ xibʼal kliswik	qum, i.m.m.
#qum# El hombre cuando	Ri achii ataq kirbʼsuj rbʼanik jun chaak, xtbsuj ri qʼiij chu rkʼisbʼaal	qum ri rkaʼyxik ri rchʼiʼ
#qum# La cara de la vaca se ve alargada	Tzʼajtzʼik rkaʼyxik ri rwoch ri waakx	qum qʼoʼl ri kʼoʼj
#qum# La araña come las moscas que están en la pared	Wu am kertij ri us ri ikʼoʼk chu xaan	qum ri ajkʼabʼ ri chʼoom
#qum# Kkanjik	Ataq kpetik nim jabʼ xibʼal ri senyabʼ	qumqumqumqumqumqumqumqumqumqumqumqumqumqumqumqumqumqumqumqum
#qum# mi papá tiene muchos parientes por eso no se mantiene en la casa	Ri wjow kʼiy richlaal sichaʼ qal kkʼuqbʼik chjaay	qum, pai meu tem muitos parentes, por isso não fica em casa.
#qum# Vejez	Ataq kpetik jabʼ njeel ri qʼoos krexbʼik	qum ri ajkʼal wu rtiʼj
#qum# Todo el maíz se apolillo	Njeel ri ixiim xpokʼrik	qum ri rqʼiij ri rbʼaʼ
#qum# por el daño que el hombre está	Ri uleew tjin rmeqʼik rum wu kʼex ri tjin kirbʼan ri achii chre	qum ri rchʼiʼ ri rchʼal ri rchʼalbʼal
#qum# La masa salió quebrada	Ri qʼoor chqaam xelul	qumsi.
#qum# La botella se utiliza para guardar miel	Ri limeet kchuknik chi r kʼolik ri ryaʼl chʼoxiʼ	qum ri ajkʼal xtzʼajik
#qum# Vamos todos para que nos atieden nuestra	Joʼ qonjeel rech xkojtaʼtjik che ri qajbʼeej	qum. We all want them to take care of ourselves.
#qum# El río creció por eso se llevó toda la	Ri nimaya ʼ xkʼiyik sichaʼ xuʼrmaʼ njeel ri tikaʼ	qumui, i'm the water that wakes up
#qum# El árbol es grandicimo por eso le pego el rayo	Jomom ri cheʼ sichaʼ xkʼeq rquljaay	qum, i'm gonna be a big tree.
#qum# El frijol que se compra en la plaza lo	Ri knaqʼ ri kloqʼik pkʼeybʼal esmaj jun pajbʼal	qum is the rim rim of the branch
#qum# Cuando cómo frijol me da ardor de pecho	Ataq kintij knaqʼ kiryaʼ qʼaʼteew chwa	qumabolobobolobolobolobolobolobolobolobolobolobolobolobolobolobolobolobolopopopopopopopopopopopopopopopopopopopopopopopopopopopopopopopopopopopopopopopopopopopopopopopopopopopopopopopopopopopopopopopopopopopopopopopopopopopopopopopopopopopopopopopopopopopopopopopopopopopopopopopopopopopopopopopopopopopopopopopopopopopopopopopopopopopopopopopopopopopopopopopopopopopopopopopopopopopopopopopopopopop
#qum# Todas las frutas están rodajeada con cuchillo	Njeel wu loʼn jexmaj rukʼ qʼatbʼal	qum: All the fruits are filmed with a knife
#qum# Ayer mi mamá compró hilo de varios colores	Iwir ri nchuch xloqʼ bʼatzʼ pkʼeybʼal jaljoj kkaʼybʼaal	qumbo.
#qum# El ladrón fue arrastrado por las	Ri elqʼoom xqitxik kum ri wnaq xaq rum wu xrelqʼaaj jun keej	qum ri kʼoʼtnik
#qum# Las matas de maguey se están secando por la plaga	Ri rqan kiiy tjin rchiqik rum wu xoʼkik chkop txeʼ	qum ri achii xbʼaanil ri rchʼiʼj
#qum# Cuando se come un chompipe quiere mucho	Ataq ktijik jun chooj nim rkunaal kraaj	qum qʼoʼj chʼoʼqʼoj xtzʼoʼl
#qum# Todo el techo de ,la casa gotea	Njeel ri rwiʼ jaay ktzʼujik	qum. The roof of the house is covered with the same roof.
#qum# Quemar bien	El enfermo se empeoro porque salio bajo la lluvia	qum xeʼ ri rchʼiibʼ
#qum# La reun ion se realiza cada semana	Ri molbʼeem kbʼanik chwuqubʼ qʼiij	qum se se se realiza semanal
#qum# El árbol se le seco las hojas	Ri cheʼ xchiqik ri rxaq	qum ri kʼolikʼulik ri rchʼiy
#qum# Con el doblador se hacen muñecas decoradas	Rukʼ wu joʼq keʼ bʼanik qʼus laj alaʼs	qum xbʼanik ri rbʼan ri rbʼan
#qum# el coyote se comió l as once ovejas	Julajuuj chiij xeʼr tij ri sjiʼl	qum ri xkʼoʼj ri rtzʼoʼj
#qum# El hombre se go lpeó la	Ri achii xkʼoxbʼsaj ri rjlom ataq xtzaqik rukʼ ri jochlan chʼiichʼ	qum ri kʼolik ri xtzʼik
#qum# El frujol blanco es delicioso comer en	Ri knaqʼ saqtbʼin chetzʼiʼnik rtijik pjkʼom iik	qumber ke ke ke ke ke ke ke ke ke ke ke ke ke ke ke ke ke ke ke ke ke ke ke ke ke ke ke ke ke ke ke ke ke ke ke ke
#qum# L avado	El cerdo ensució el maíz	qum.
#qum# La mujer hace lasos con la	Ri ixoq kiʼrbʼan ri klobʼ rukʼ ri saqkiiy ri kirbʼan rukʼ ri choʼl	qum ri rkaʼyʼ ri ajkʼal
#qum# El ayote es bien rico pa ra comer	Chetzʼiʼnik rtijik ri qʼooqʼ	qum xʼiiʼ ri chʼoʼl
#qum# Cerca murió el marido de la mujer	Nqaaj waʼchiʼ xchupik ri rchjiil ri ixoq	qum.
#qum# Todo el tamal estaba comido por las ratas	Njeel ri subʼ tijmaj rum chʼoo y ataq xojsaqrik	qum qʼuʼj qʼuʼj qʼoʼj
#qum# Arena	Ataq kiʼjikxik ri cheʼ ri uleew sbʼajbʼoj kkanjik	qum ri xkʼuʼ ri rkaʼj
#qum# El formón lo utiliza el carpintero	Ri tzʼqubʼ kchuknik chu ri jsol cheʼ	qum ri xkʼulbʼal ri rchʼaʼj
#qum# El conejo cuando hay buena luna sale a comer el frijol	Ri imul ataq kʼolik rqan iikʼ kelul chirtijik wu knaqʼ	qum. I have to go out.
#qum# La mujer cuando mató a la gallina	Ri ixoq ataq xwiʼtaaj ri akʼ kʼa xlechʼpij ri rtzʼumil	qumililqqqqqqqqqqqqqqqqqqqqqqqqqqqqqqqqqqqqqqqqqqqqqqqqqqqqqqqqqqqqqqqqqqqqqqqqqqqqqqqqqqqqqqqqqqqqqqqqqqqqqqqqqqqqqqqqqqqqqqqqqqqqqqqqqqqqqqqqqqqqqqqqqqqqqqqqqqqqqqqqqqqqqqqqqqqqqqqqqqqqqqqqqqqqqqqqqqqq
#qum# El documeto del terreno está ahumado	Ri rjujil uleew xsibʼrik wu riij	qum. The landing document is smoked.
#qum# La flor de milpa lo come las chorchas	Ri tzʼtuj ktij tochʼaʼ chu kwoy	qum ri ajkʼal ri rchʼiʼl
#qum# Es necesario cuidar la naturaleza	Riliil riij xtloqʼxik ri uleew	qum, o, o, o, o, o, o, o o, o o o o o o o o o o o o o o o o o o o o o o o o o o o o o o o o o o o o o o o o o o o o o o o o o o o o o o o o o o o o o o o o o o o o o o o o o o o o o o o o o o o o o o o o o o o o o o o o o o o o o o o o o o o o o o o o o o o o o o o o o o
#qum# La mayoría de los niños consumen mucha galguería	Ri knimalil ri ajkʼalobʼ ktij tzʼiʼlil	qum xbʼaan ri rwiʼ ri rchʼyaʼl
#qum# Cuando entra el verano las vacas se ponen flacos	Ataq kokik saqʼiij yaax keʼlik ri waakx	qumle
#qum# El niño se majó el dedo	Ri ajkʼaal xwochʼ wu rwiʼ rqʼabʼ	qum!
#qum# Boca arriba	Ri nchuch xloqʼ ri paa kʼ pkʼeybʼal	qum.Please put the neck on top.
#qum# El niño no guantó porque se le regó agua	Ri ajkʼaal qal xchʼij kumu kʼten yaʼ xtixuul chriij	qum. I.e. The boy didn't carry apples because there was water.
#qum# La mariposa vuela entre las flores	Wu puʼt kxikʼnik chu taq ri kotzʼaj	qum ri rchʼabʼ ri rbʼaan ri rkaʼbʼal
#qum# Todos los enfermos sanaron	Njeel ri ya abʼ mixuʼtzrik	qum riij xbʼaal
#qum# La milpa se secó porque le cayó hielo	Ri chnooj xchiqik kumu xqaaj teew chriij	qumseed. The cancho has dried up because the ice has been
#qum# El frijol amarillo da cuando se siembra	Ri xpley kiryaʼ ataq jnum kawxik rukʼ ri chnooj	qum riij xtzʼoʼl
#qum# El agua tiene pureza	Ri yaʼ kʼolik rsaqiil	qumla
#qum# El techo de la casa de mi papá se ve de forma triangulo	Jutzʼjik rkaʼxik ri rwiʼ rchoch wjow	qum. Aim. Aim. Aim.
#qum# Cuando el buhuo llega a	Ataq koʼqʼoʼk ri toltol chjaay labʼnel kʼolik chinaq xtkmik	qum wu rbʼaaj wu rchʼuʼ
#qum# La reunión de los estudiantes se hizo anteayer	Ri molbʼeem kech ri aj tijnel xbʼanik kabʼjiir	qum riij ri rkaʼ riij
#qum# Mi mamá tiene sirvienta	Ri nchuch kʼolik rmkoom	qum.
#qum# Los niños empezaron a llorar cuando perdieron	Ri ajkʼalobʼ xeʼoqʼik rum qal xkchʼak ri etzʼnim	qumile.
#qum# Nuestro idioma es el Sipakapense	Ri qyolbʼaal areʼ ri Sipakapense	qum ri ajkʼal ri xtzʼakʼ ri rkaʼbʼeem
#qum# Por un poco no alcanzo el fuego la otra casa	Xaq qiʼn chik qal xmaj qʼaaqʼ ri jun jaay chik	qumile.
#qum# El mal de ojo les afecta a los	Ri rbʼaqʼ rwoch wnaq kirbʼan kʼex chke ri ajkʼ a lobʼ	qum xbʼiʼbʼal ri rqaʼ ri rchʼiʼl
#qum# No es bueno comer el sobrante al otro día	Qal utz xtqtij ri chʼqaap	qumili.
#qum# A todas las	Chke njeel ri wnaq xbʼiʼxik ke qal xeʼlbʼik xkoybʼeej ke xkʼisik ri molbʼeem	qum rukʼ ri rkaʼ ri rchʼuʼ
#qum# Para la fiesta del pueblo todos damos la contribución Ri achii xkanajken	Rech ri nima qʼiij rech tinmit qonjeel qyaʼ ri kchuuj	qumqumqumqumqumqumqumqumqumqumqumqumqumqumqumqumqum
#qum# Todo el trabajo que se realizó estaba bien pensado por eso salió bien	Njeel ri chaak ri xbʼanik bʼusmaj riij sichaʼ utz xeʼloq	qum, i.e. everything we've done has been well thought out, so it's been okay
#qum# Por allá está la casa de mi hermana	Tukkilaʼ kʼolik r i rchoch ri wnobʼ	qum.
#qum# Las flores que tiene sembrado mi mamá son de color rojo	Njeel ri kotzʼaj ri rawmaj ri nchucch keq rkaʼybʼaal	qum. The flowers that my mother planted are roses.
#qum# Los trabajos de los antiguos ya no se encuentran	Ri kchak ri ojor wnaq qaqchee chik kiʼ riqt jik	qum, i.e. i.e. i.e. i.e.e.e. i.e.e.o
#qum# El granizo golpeo la milpa	Ri saqbʼuch xkʼoxbʼsaaj ri chno oj	qum ri loʼn xtzʼolik ri rbʼanik
#qum# Al niño le da estornudo	wu ajkʼaal kiryaʼ achyam chre	qumle
#qum# Codo	Pongale una cuña a la mesa	qum ri rqʼoʼxʼtzʼik ri rchʼuʼ
#qum# Salimos rápido por eso regresamos juntos	Cha niim xojelbʼ ik sichaʼ xojtz aljuul jnum	qumqumqumqumqumqumqumqumqumqumqumqumqumqumqumqumhumhumhumhumhumhumhum
#qum# El lápiz del estudiante se quebró	Ri rtzʼibʼbʼaal ri ajtijnel xqʼeptjik	qumqumqumqumqumqumqumqumqumqumqumqumqumqumqumqum
#qum# El cabello de la señorita está trensado con su	Ri rwiʼ ri aliit pochʼmaj rukʼ ri rxqʼap	qum ri rwiʼl riij ri rbʼal
#qum# Ante el juez no se presentó el acusador	Chu ri qʼtal iil qal ri tzujnel xopnik	qum, a.m.p.
#qum# C ama wu chʼaat bʼantlik rukʼ	Estaba mojado la camisa del hombre por eso le dio fiebre	qum kirbʼaʼn ri rkʼaʼy
#qum# El hom bre tiene bellos en el pecho	ri achii kʼolik rsmaal chu rkʼuʼx	qum ri ajkʼaal ri rbʼaj
#qum# Pizarron	La tabla es ancha	qum ri rbʼaaʼ ri rkaʼyxik
#qum# El bebé gatea en el patio de la casa	Ri neʼ kchaknik pirqan jaay	qum ri rbʼaal
#qum# Hay personas que ya no se recuerda de	Kʼolik wnaq qal chik knaʼtaj ri kbʼanbʼaal chke	qum ri xbʼaal ri rkaʼyxik
#qum# La señora ronca mucho cuando duerme	Wu ixoq kjororik wu rtzaʼm ataq kwrik	qum. The lady cries a lot when she's sleeping.
#qum# La hoja de papel esta medio pegado	Ri rxaq juuj xaq qiʼn nakʼlook	qumablo is a bit of a bitch
#qum# La gente cando existe entre ellos un problema se desprecian	Ri wnaq ataq kʼolik jun chʼoʼj chkxoʼl ketzlaj kiibʼ	qum, se, se, se, se, se, se, se se, se se
#qum# El encendedor sirve para juntar el	Ri tʼiqbʼal kchuknik chu rnukʼik ri qʼaaqʼ	qum xtʼoʼl ri rkaʼx ri rchʼul
#qum# Cuando se junta	Ataq kmo lik ri knaqʼ kʼolik rkʼolbʼaal waʼchiʼ kyoʼqqaj wiʼ	qumate one on the other
#qum# Donde yo vivo es tierra caliente	Ri waʼchiʼ kʼo ri wchoch mqʼen jyubʼ	qum' i'm going to the land where i live
#qum# C uando amanecemos el gallo canta	Ataq kojsaqrik ri tzeek koqʼik	qumle se voqqqqqqqqqqqqqqqqqqqqqqqqqqqqqqqqqqqqqqqqqqqqqqqqqqqqqqqqqqqqqqqqqqqqqqqqqqqqqqqqqqqqqqqqqqqqqqqqqqqqqqqqqqqqqqqqqqqqqqqqqqqqqqqqqqqqqqqqqqqqqqqqqqqqqqqqqqqqqqqqqqqqqqqqqqqqqqqqqqqqqqqqqqqqqqqqqqq
#qum# Todas las bancas son redondas	Njeel ri teem isetsik	qum ri xkʼuʼl ri rchʼiʼj
#qum# Cuando se tapisca la	Ataq kjachʼik ri jal xaq xeew ri rqan chnooj kkanjik	qum xbʼanik ri kʼolik ri rkʼolik
#qum# La masa salió fino en el molino	wu qʼoor kookʼ xelul pwu keʼbʼal	qumililmmiilmiilmiilmiilmilmiilmilmiilmilmilmilmilmilmilmilmilmilmilmilmilmilmilmilmilmil
#qum# Ri ixoq	Tráigalo	qum ri xchʼuʼl ri rbʼaal
#qum# La escuela cumplió el decimo sexto año de	Rwaqlaaj rjnobʼ ri tijbʼal xtzʼaqtik	qum qaqʼoʼn
#qum# La fruta está medio ácido	Ri loʼn chʼomchʼoj rtijik	qumqumqumqumqumqumqumqumqumqumqumqumqumqumqumqum
#qum# Los zapatos de mi abuelo es de color negro	Ri rxjabʼ ntatanool qʼeq kkaʼybʼaal	qum ri rkaʼj riij ri rkaʼyik
#qum# Todas las hojas de papel se perforó	Njeel ri rxaq juuj xeʼ worik	qum xojbʼal ri rkʼolik ri rbʼanik
#qum# La vaca es de mejilla gorda Extendido	Ri waakx lewlik wu rwoch	qum ri rkaʼyxik ri rchʼiʼl
#qum# Para espantar a los zanates sirve la onda de pita	Chu kxibʼxik ri chʼok kchuknik ri ixkeeqʼ	qumilito de lacha
#qum# Todos los niños se dispersaron por el miedo	Njeel ri ajkʼalobʼ xiʼ tuknik rum xibʼal kiibʼ	qum. -Here. -All the children are scattered by fear.
#qum# El hombre ya es viejo por eso no aguanta caminar	Ri achii riʼj chik sichaʼ qal kirchʼij kbʼinik	qum. A.k.s.
#qum# Es necesario mostrar lo que se quiere	Riliil riij xtkʼutik ri kajwxik rbʼanik kukʼ ri wnaq	qum, i.e.
#qum# La	Ri yuʼtz kʼebʼ muul xchuknik sichaʼ kamulbʼal rbʼiʼxik pqyolbʼaal	qum kʼoʼj riij
#qum# La tortuguilla terminó de comer el frijol	Wu leem xkʼis ri knaqʼ	qumilil i i i i i i i i i i i i i i i i i i i i i i iilil
#qum# L a haba se muele para pinol	Wu jaws kkeʼxik chu kʼej	qum ri ajkʼal ri rkʼal ri rʼiij
#qum# El trabajo está duro por eso no avanzaron los trabajadores	Wu chaak kow sichaʼ qal nim xkbʼan ri ajchaak	qum, so the workers can't go on.
#qum# La olla grande es de boca grande	Wu nima xbʼoʼj leʼlik wu rchiʼ	qumsu-kramsu-kramsu-kramsu-kramsu-kramsu-kramsu-kramsu-kramsu-kramsu-kramsu-kramsu-kramsu-kramsu-
#qum# La abuela le duele su hueso	Ri nooy kiʼ qʼoxwik ri rbʼaqil	qum. -Amoz lesioned his bone.
#qum# Mi perro se murió despacio ór la vejez	Tkaal xkmik ri ntzʼiʼ rum riʼjaal	qumililqililqililqililqililqililqililqililqililqililqililqililqililqililqilillechlechlechlechlechlech char char char char char char char char char char char char char char char char char char char char char char char char char char char char char char char char char char char char char char char char char char char char char char char char char char char char char char char char char char char char char char char char char char char char char char char char char char char char char char char char char char char char char char char char char char char char char char char char char char char char char char char char char char char char char char char char char char char char char char char char char char char char char char char char char char char char char char char char char char char char char char char char char char char char
#qum# En la reunión llegaron solo dos mujeres	Pri molbʼeem xaq kʼeebʼ ixoq xoʼpnik	qum.
#qum# Si hablamos con la verdad	Saqsi xkojyolwik chqatziij rtqriq kʼchiʼ ri utziil	qumll.
#qum# En el terreno hay montones de piedras	Pri uleew kʼolik kʼiy amluʼx abʼaj	qum a bunch of knife turtles
#qum# Para que no nos critiquen es bueno pagar la deuda	Rech qal xkojyolik, utz xttojik ri kʼaas	qum , o , o , o , o , o , o , o , o , o , o o o o o o o o o o o o o o o o o o o o o o o o o o o o o o o o o o o o o o o o o o o o o o o o o o o o o o o o o o o o o o o o o o o o o o o o o o o o o o o o o o o o o o o o o o o o o o o o o o o o o o o o o o o o o o o o o o o o o o o o o o o o o o o o o o o o o o o o o o
#qum# Las aguas estancadas no es bueno	Ri tikʼlik yaʼ qal utz kumu kiʼ poqʼnik ri raal us	qum xtzʼulik ri rchʼuʼl riij ri rbʼal
#qum# El perro es travieso	Ri tzʼiʼ xwos	qum xkʼoʼn ri rkʼolik
#qum# Existen personas que no creen en las imágenes	Kʼolik ri wnaq qal knmaj ri tyoox	qum.Meher.M.M.M.S.
#qum# Que fecha nació mi hermano	Che rajlbʼaal rkʼosbʼik r i wtziik	qum,t.t.
#qum# M i mamá está enfermo de la tos	Ri nchuch yaabʼ rukʼ rqul	qum.
#qum# la comadrona vive en el traingulo	Ri ajkuun tlaʼ kʼolik rchoch waʼchiʼ rbʼiʼ oxchʼuʼk	qum, ojo, ojo, ojojo, ojo, ojo
#qum# La gall inaza es bueno para abonar la siembra	Ri rchaq akʼ utz xtqajik chxeʼ ri tikaʼ	qumabolo
#qum# Cuando hay charcos de agua	Ataq kʼolik yaʼ tikʼlik xibʼal serat kiʼpoqʼnik	qum rkaʼyxik ri rkaʼxbʼal
#qum# El ladrón entró arriba por eso no se dio cuenta el perro	ajsik xokul ri elqʼoom sicha ʼ qal xnaʼ ri tzʼiʼ	qum, i.e. the dog didn't realize it.
#qum# Cuando nacio el niño lo	Ataq xkʼosbʼik ri ajkʼaal rbʼaqʼtmaj riibʼ ri rkʼamaʼl rmuux pirqul	"qumle, ""When the child is"
#qum# El caballo tiene los ojos grandes	Ri keej bʼilbʼik wu rbʼaq rwoch	qum, i. - - - - - - - - - - - - - - - - - - - - - - - - - - - - - - - - - - - - - - - - - - - - - - - - - - - - - - - - - - - - - - - - - - - - - - - - - - - - - - - - - - - - - - - - - - - - - - - - - - - - - - - - - - - - - - - - - - - - - - - - - - - - - - - - - - - - - - - - - - - - - - - - - - - - - - - - - - - - - - - - - - - - - - - - - - - - - - - - - - - - - - - - - - - - - - - - - - -
#qum# Barrendero	El cuarto lo han barrido	qum ri ajkʼal ri xtzʼiij
#qum# Mi mamá puede hacer petate	Ri nchuch utz keʼrbʼan ri xkulbʼal	qum ri rqʼiij ri rkaʼyxik ri rkaʼy
#qum# La en voltura del papel está hecho de algodón	Ri pisbʼal ri juuj bʼantlik rukʼ miit	qum ri ajkʼal ri rbʼaal ri rkʼiij
#qum# Todos los negocios están cerrados	Njeel ri kʼyeej itzʼaplik	qum! -Shop's all about to go!
#qum# Dirrecion	Xsqarsxik ri riil ri achii se aclaró el delito del hombre	qum ri ajkʼaal xtkʼeʼ
#qum# En el camino se regó arena	Chpom ri bʼeey xtukxik poqlaaj	qumamomomomomomomomomomomomomomomomomomomomomomomomomomomomomomomomomomomomououozozozozozozozozozozozozozozozozozozozozozozozozozozozozozozozozozozozozozozozozozozozozozozozozozozozozozozozozozozozozozozozozozozozozozozozozozozozozozozozozozozozozozozozozozozozozozozozozozozozozozozozozozozozozozozozozozozozozozozozozozozozozozozozozozozozozozozozozozozozozozozozozozozozozozozozozozozozozozozozoz
#qum# La ropa está mojada	Ri sʼaq tʼaq	qumilite.
#qum# Cuando el perro olió las huellas del	Ataq xsiq ri tzʼiʼ ri qan chkop xtrambʼeej rech xwiʼtaaj	qum xbʼaʼbʼal ri rchʼiʼ
#qum# La señorita se le cayó la muela	Ri aliit xtzaqeel wu rkaʼ	qum. The woman has lost her tooth.
#qum# El perro lo hirió al hombre en la fosa poplítea	Ri tzʼiʼ xsok ri achii pirsmoqʼ	qum! The dog has wound the man in the killing strip.
#qum# El consumo del cigarro daña el cerebro	Ri siikʼ kirbʼan kʼex chu ri tzantzqʼor	qum ri rkaʼy chʼiich
#qum# Frijol	Ataq kpetik jabʼ wu kʼotzʼaj qʼus kkaʼyxik	qum ri kʼolik ri rchʼiʼj
#qum# Cuando está bien hecho el trabajo no es necesario repasarlo	Ataq utz bʼanmaj ri chaak qal chik ktzuntzxik	qum, a) a) a) a) a) a) a) a) a) a) a) a) a) b) a) a) b) a) a) b) a) b) a
#qum# El hombre que mató a la mujer es el culpable	Ri ajmaak areʼ ri achi i ri xwiʼt aaj ri ixoq	qum.
#qum# El pajon blanco sirve para elaborar canastas	Ri saqkʼim kchuknik chu kbʼanik xuʼk	qum xeʼtzik ri rqʼabʼ
#qum# La casa es muy reducido por eso no	Latzʼ wu rpom jaay sichaʼ qal xiʼ kʼisook njeel ri wnaq	qum.
#qum# Cunado cae las primeras lluvias salen	Ataq kqajik ri nabʼey rqan jabʼ keʼlul ri xkawalek	qum wu rtiʼy ri rbʼan ri rchʼaʼ
#qum# El aguardiente causa daños a nuestro hígado	Ri xbʼaj kirbʼan kʼex chu ri qsosobʼ	qum, i.e.
#qum# Debajo de las piedras están las culebras	Xeʼ taq ri abʼaj kiʼkʼobʼik ri kmatz	qumile
#qum# La siembra crece con el calor del sol	Ri tikaʼ kkʼiyik rum ri rmeqʼnal ri qʼiij	qum ri chaakʼ xtzʼaj
#qum# Entre seis meses va parir la vaca	Waqiibʼ iikʼ chi k xtqajik raal wu wakx	qum xbʼeʼkʼik ri xtzʼaʼl
#qum# Esto lo dijo un chismoso	Jun mlol ylooj xb ʼiʼnik re waʼ	qum.
#qum# La nuera se le puso a	Ri albʼatz xyoʼqook chu rqirxik ri rwoch ixiim	qumleququestylequestylequestylequestylequestylequestylequestolaolaolaolaolaolaolaola
#qum# En la cima del cerro fuimos hacer la ceremonia maya	Pirwiʼ ri jyubʼ xeʼqbʼnaʼ ri chʼabʼal maaya	qum xʼiʼj ri xkʼoʼj
#qum# El muchacho se cortó el pie con el machete	R i alaabʼ xtochʼ ri rqan rukʼ ri tochʼbʼal	qumile i-i-i-i-i-i-i-i-i-i-i-i-i-i-i-i-i-i-i-i-i-i-i-i-i-i-i-i-i
#qum# Los ladrones de noche robaron la vaca de mi papá	Ri elqʼoom chaqʼabʼ xkelqʼaaj ri rwaakx wjow	qumilika.
#qum# la señora siempre padece del catarro	Ri nanyoox xaq kyabʼabʼ ik rum wu re tzaʼm	qumlack always has snow.
#qum# Mi hermano construyó su casa retirado a la mia	Najeʼl xbʼan ri wtziik ri rchoch	qum. -About. -About me.
#qum# La señorita tiene los pechos grandes	Ri aliit nmaq wu riim	qum, i'm not a big girl.
#qum# El buche de la gallina se llenó con granos de maíz	Ri rbʼuch akʼ xnojik rukʼ rwoch ixiim	qumpa choke choke choke choke choke choke choke choke choke choke chair chair chair chair chair chair chair chair chair chair chair chair chair chair chair chair chair chair chair chair chair chair chair chair chair chair chair chair chair chair chair chair chair chair chair chair chair chair chair chair chair chair chair chair chair chair chair chair chair chair chair chair chair chair chair chair chair chair chair chair chair chair chair chair chair chair chair chair chair chair chair chair chair chair chair chair chair chair chair chair chair chair chair chair chair chair chair chair chair chair chair chair chair chair chair chair chair chair chair chair chair chair chair chair chair chair chair chair chair chair chair chair chair chair chair chair chair chair chair chair chair chair chair chair chair chair chair chair chair chair chair chair chair chair chair chair chair chair chair chair chair chair chair chair chair chair chair chair chair chair chair chair chair chair chair chair chair chair chair chair chair chair chair chair chair chair chair chair chair chair chair chair chair chair chair chair chair
#qum# En mi pueblo hay pocos ladinos	Pri ntinmit qal kʼiy moos ikʼolik	qum's only a little bit
#qum# El cuero se secó en el sol	Ri tzʼuum xchiqik chu qʼiij	qum xtzʼolik ri rqʼoʼl
#qum# El niño está enfermo por eso no puede reir	Ri ajkʼaal yaabʼ sichaʼ qal ktzeʼnik	qum. I'm sick. That's why he can't laugh.
#qum# La mosca es un animal malo porque contamina lo	Wu us qal utz laj chkop kir chʼulchʼaʼ ri che ri qtij	qumilic is a bad animal because it's the one that's gonna make him
#qum# Cuando los niños se levantan todos cantan	Ataq kiʼ waʼljik ri ajkʼalobʼ konjeel keʼ bʼixnik	qumile. I mean, when the kids get up the
#qum# A los niños es necesario enseñarles a saludar	Chke ri ajkʼalobʼ riliil rij xkeʼtijxik rech xkeʼqʼajlaʼnik	"qum, ""Hello, hello, hello"""
#qum# El escritor escribió varios cuentos en el	Ri ajtzʼibʼnel xeʼrtzʼibʼaaj kʼiy q taʼ pqyolbʼaal	qum tzʼiʼj ri rbʼajik
#qum# La señora preguntó cuanto vale la gallina	Ri ixoq xtzʼonjok jrubʼ rjil wu akʼ	"qum. ""Animal value of the rooster""."
#qum# El lazo se estiro porque se mojó	wu klobʼ xyuqpjik ataq xchnaʼnik	qum.
#qum# Sapo	La laga rtija sale cuando hay sol	qum xtzʼiʼ ri rqʼiij
#qum# El trozo ya está seco	Ri xaʼk chqiʼj chik	qum, i'm getting wet.
#qum# Para curar la tos es bueno el jengibre	Ri xenxipr utz chi kunbʼal ri qulaj	qum xbʼaʼ ri rchʼiʼj ri rkaʼybʼal
#qum# El laso lo hacen torcer con malacates	Ri klobʼ ktumxik rukʼ xweelx	qum ri rkʼiij xtzʼiij ri rkʼiij
#qum# El agua de la	Ri ryaʼl tzmeʼy utz xtqum jun ixoq rech q al ri raal xtokʼwik	qum xeʼ ri xbʼal ri rkʼiij
#qum# El borracho cuando cayó quedó de boca arriba	Ri qʼabʼreel pakʼlik xkanjik ataq xtzaqik	"qum, i. ""Evehu, as he fell, he put on his head""."
#qum# El hombre cuando se fue a traer leña no llevó su mecapal	Ri achii ataq xbʼeek chu rkʼamik siʼ qal xkʼambʼik ri rptem	qum ri rbʼaʼ ri rwiʼtjik ri rchʼaʼl
#qum# El año pasado se fundó el caserío	Junbʼer xkʼuqbʼsxik ri rwiʼ rqʼabʼ tinmit	qumme house last year.
#qum# Rech ri tinmit	Njeel jnobʼ kbʼanik ri nimaqʼʼij	qum xqʼiij ri rchʼabʼal
#qum# A la mujer le dió vahído	Ri ixoq xpe saqtqoj chriij	qum kʼoʼn chʼoʼn
#qum# El muchacho se cayó y se quebró la mano	Ri alaabʼ xtzaqik xqʼoch wu rqʼabʼ	qum, i. - The boy fell down and broke his arm.
#qum# Mi hermano apuntaló su casa	Ri wtziik xaq xchʼutij ri rchoch	qum. My brother has destroyed his house.
#qum# al otro lado del rio está la casa de Elena	Chqʼayaʼpon ri yaʼ kʼolik rchoch ri Leʼn	qum xkʼuʼj ri rkʼiij ri rkʼolik
#qum# La cola de gallo sirve para adornar	wu ekʼaʼ kchuknik chu wiqbʼal	qum wu xbʼaal
#qum# Dolor	Iwir xintzaqken ri qʼaxbʼal chaʼnbʼal ayer perdí el teléfono	qumik ri ajkʼal ri ajkʼal riij xbʼaʼ
#qum# Mi tío tiene dos hijastras	Ri wkaan kʼolik kʼeebʼ rmyaʼlbʼaal	qum.
#qum# Palo blanco	Ri saqʼuul xaq tqʼaaj kiryaʼ wiʼ, El plátano solo se da en la costa	qum ri rkaʼxbʼallik ri rxbʼal
#qum# Ayer en la tarde estuvimos en una reunión	Iwir xqʼeq xojkʼobʼik pjun molbʼeem	qum. Yesterday afternoon, we were in a meeting.
#qum# El niño se debe agarrar de la mano	Ri ajkʼaal riliil rij kyuqxik chu ri rqʼabʼ	qum: The child has to be held in his hand
#qum# El maestro lo mando a serntar al abuelo en la silla	Ri ajtiij xkʼuqbʼaʼ ri tatanool chu teem	qum.Master sends him to the chair chair chair chair chair chair chair chair chair chair chair chair chair chair chair chair chair chair chair chair chair chair chair chair chair chair chair chair chair chair chair chair chair chair chair chair chair chair chair chair chair chair chair chair chair chair chair chair chair chair chair chair chair chair chair chair chair chair chair chair chair chair chair chair chair chair chair chair chair chair chair chair chair chair chair chair chair chair chair chair chair chair chair chair chair chair chair chair chair chair chair chair chair chair chair chair chair chair chair chair chair chair chair
#qum# Todos tomamos atol	Qonjeel qqum qʼoor	qum ri rchʼal ri rchʼiʼj
#qum# Dentro de un año	A qué hora nos vamos al entierro	qum xeʼ ri rchʼiʼj ri rkaʼtjik
#qum# Las frutas se ven grandes	Wu loʼn nmaq kkaʼyxik	qum xkʼeebʼ ri rkaʼyxik ri rchʼiij
#qum# El cerdo tiene mucho piojo	Ri kuch xibʼal squkʼ chriij	qum wu rkaʼyʼyxik ri rkʼoʼl
#qum# El bebé no aguantó la fiebre	Ri lochʼ qal xchʼij ri qʼaaqʼ xelul chriij	qum. Baby couldn't stand the fever.
#qum# la señorita cuando viaja en carro le da vómito	Ri aliit ataq kbʼeek pchʼiichʼ kiryaʼ xaʼw chre	qum. The lady when she travels with the carriage gives it to her.
#qum# La gente pelean por el agua	Ri winaq keʼchʼoʼ jnik chrij ri yaʼ	qum, a.k.a.
#qum# Mi papá todos los días se mantiene ocupado	Ri wjow njeel qʼiij qal jamlik	qum.Mommy.
#qum# En frente la iglesia	Chu wu jaay rech chʼabʼal kʼolik kʼeebʼ mulmik uleew	qum ri rkaʼbʼanik ri rkʼolik
#qum# el árbol quedó atravesado en el camino	Ri cheʼ qʼeʼlik xk anjik pri bʼeey	qumile.
#qum# El color de la oveja es medio negro	Ri chiij qʼeqqʼoj rkaʼybʼaal	"qum: ""R"""
#qum# Es necesario cuando tomamos el agua	Riliil riij ataq xtqum ri yaʼ nabʼeey xtrqowsxik	qum, i.e. when we drink water
#qum# La fruta se endulza con los rayos del sol	Ri rwoch tikaʼ kkiʼyrik rum wu rtun qʼiij	qumʼ ri chʼiʼl xkʼoʼn
#qum# La fruta del nopal tiene mucha espina	Ri rwoch nuxtaʼ xibʼal rkʼixil	qum qʼxikʼik ri rkaʼn
#qum# La señorita c uida al bebé	Ri aliit kiryqʼuj ri ajkʼaal	qum ri ajkʼal ri rkaʼy ri rkaʼtzʼal
#qum# En el agua encharcada hay mucho zancudo	Chpom ri yaʼ piʼlik xibʼal xaʼn	qum xbʼaal ri rbʼal ri rkaʼtzʼik
#qum# El perro ronronea cuando mira su	Ri tzʼiʼ ktzʼuʼynjik ataq kirkaʼyij wu rxoqʼjowil	qum xtzʼolik ri rbʼaal
#qum# Cuando llegamos ya estaba abierto la	Ataq xojopnik jaqlik chik ri rchiʼ jaay jroq koʼkik elqʼoom	qum, when we arrived, the door was already open.
#qum# El niño se enfermo de dearrea	Ri ajkʼaal xyabʼrik rukʼ xjir	qum ri ajkʼal ri ajkʼal
#qum# Las hormigas comen la migaja de tortilla	Ri snik ktij ri rxiʼl leej	qum ri xkʼolik ri rchʼabʼal
#qum# Los que engalanan la fiesta son las bellas mujeres	Ri kiʼ wiqnik ri nima qʼiij areʼ ri qʼus laj taq ixoq	qum.
#qum# El durazno está desabrido	Ri traas spoqʼpoj rtijik	qumlo.
#qum# La sábila es bueno para las quebraduras	Ri wiqabʼaaq kchuknik chu ri qʼajaʼ	qum qʼoʼl riij chʼuʼl
#qum# El bebé ya no pudo mamar porque se le	Ri ajkʼa al qal chik xtuʼnik rum wu xsopjik wu rqul	qum. Bebé no podía amamantar más porque le le
#qum# Todos los	Qonjeel wu ojkʼolik chu rwoch paxil nkareʼ xaq jnum ri qbʼanbʼaal	qum ri ajkʼaal xbʼiij
#qum# El m uchacho mató una ardilla con su onda	Ri alaabʼ xwiʼtaj jun kuuk rukʼ ri r chʼaabʼ	qumle. The child has killed tortoise with his wave.
#qum# La rodilla de mi hermano se quebró cuando le cayó un trozo encima	Ri rchʼeek wtziik xqʼajik ataq xtzaquul jun xaʼk chriij	qum, um, um, um, um... um... um... um... um... um... um... um... um... um... um... um... um... um... um... um... um... um... um... um... um... um... um... um... um... um... um... um... um... um... um... um... um... um... um... um... um... um... um... um... um... um... um... um... um... um... um... um... um... um... um... um... um... um...
#qum# El dor mitorio es limpio	Ri wurbʼal kchʼajchʼtik	qum xeʼ ri rchʼuʼ ri rbʼal
#qum# El carro se fue directo al barranco	Ri chʼiichʼ suukʼ xbʼeek pswon	qumqumqumqumqumqumqumqumqumqumqumqumqum
#qum# En el terreno hay varios muros	chpom ri uleew kʼiy kʼulbʼat ikʼolik	qum ri rbʼanik ri rkʼoʼj
#qum# Una vez se dice que lo más importante es el respeto	Jumul xtbʼiʼxik ke ri qatz riliil riij areʼ ri nimneem	qum. Se, se, se, se, se, se, se, se, se
#qum# El caldo salió medio salado	Ri ryaʼl iik tzeytzoj xelik	qum.
#qum# Cuando caminamos mucho los pies nos	Ataq kojbʼinik nim tʼuus keʼlik ri qqan	qummochebakebakebakebakebakebakebakebakebakebakebakebakebakebakebakamaamaamaamaamaamaamaamaamaamaamaamaamaamaamaamaamaama
#qum# Cuando desaté la pita es fácil arrollar en un olote	Ataq xinsol ri kʼaam xinbʼotzʼ chrij jun piʼq	qum ri rbʼal ri xbʼoʼl ri chaʼ ri rkʼuʼ
#qum# El chichicaste tiene mucha espina	Xibʼal rkʼixil ri yeel	qum.
#qum# Para la fiesta trabajaron dos recepcionista	Pri nimaqʼiij xeʼchuknik kʼeebʼ ulanel	qumilitojojojojojojojojojojojojojojojojojojojojojojojo
#qum# A ellos les dieron el dinero para hacer la fiesta	Chke xyoʼqik njeel ri poq chi rbʼanik ri nimaqʼiij	qum. They got the party money.
#qum# Mi sobrino es un buen hombre	Ri wkaaqʼ areʼ jun utz laj achii	qum. I mean, my firstborn is a good man.
#qum# El cuero estaá extendido en el suelo	Ri tzʼuu m likʼmaj rwoch chu uleew	qum kirbʼal ri rchʼuʼj
#qum# Por estar	Rum wu qal tzʼqaat ri rpajbʼaal ri ajkʼeynel sichaʼ xbʼeek pcheʼ	qum ri rbʼoʼl ri rchʼiʼj
#qum# El atol no se pudo tomar	Ri qʼoor qal xqumik kʼten xtewrsxik tekʼchi xjachik	qumle couldn't be taken.
#qum# Temascal	Ri wakx jurjik ri raaqʼ La vaca tiene la lengua larga	qum ri xqʼiij ri rwiʼxbʼanik
#qum# No es bueno prestar algo a alguien porque se adueña	Qal utz xtqyaʼ jun che chqoom ri wnaq kʼa krechbʼeej	qum. Ne, ne, ne, ne, ne, ne, ne, ne ne, ne, ne, ne, ne ne ne ne ne
#qum# El cuero que tiene el sentadero se	Ri tzʼuum ri kʼaʼn chu ri kʼuqulbʼal mixjarik	qum wu xbʼal ri rchʼiʼj
#qum# El hombre cuando siembra busca	Ri achii ataq kir bʼan ri awaʼn kertaqiij ajchaak chu rtoxik	qum ri kʼolik ri kʼolik ri rkaʼy
#qum# La gallina clueca se mur ió	Xkmik ri tʼuq laj akʼ	qum riij ri qʼiij ri rqʼiij
#qum# Mi mamá compró una servilleta	Ri nchuch xloqʼ jun suʼbʼal qʼabʼ	qum. My mom bought him a palette of apple
#qum# es bueno regalar dinero pero a los huérfanos	Utz xtqsipaj ri poq nuʼj chke ri mebʼaʼ	qum, pero bueno dar dinero a los orfanitos
#qum# Mi casa es de color v erde	Ri wchoch rex ri rkaʼybʼaal	qum ri ajkʼal ri rbʼal
#qum# cuando hay nube en el cielo es seña que	Ataq kʼolik muuj chukaaj retal kʼchiʼ kpetik jabʼ	qum, i.e. i.e. i.e. i.e. i.e. i.e.e. i.e.e.
#qum# Las crías de la marrana que cayero son hembras	Ri raal kuch xiʼ qajik tiʼt njeel	qum xbʼiʼj ri rbʼeybʼal ri rchʼiʼ
#qum# mi mamá lo quemó su paleta	Ri nchuch xproj ri rtkuʼl	qum.
#qum# La comida es bien ssabrosa	Ri rtibʼliil woy chetzʼini k rtijik	qum, i. I.e.
#qum# Cuando salimos al mirador el pueblo se mira bello	Ataq xojelpoon chu ri ilbʼal qʼus rkaʼyxik ri tinmit	qumayo. When we go to the viewfinder, the village has a beautiful view
#qum# El guisquil es bueno que	Wu chʼmaay utz xtktij ri ajkʼlobʼ rech xtkʼobʼik kchoqʼaabʼ	qum ri rkaʼyubʼ ri rqʼiij
#qum# Cuando se reunieron los	Ataq xkmol kiibʼ ri aloʼm xkbʼanken jun etzlaal chu ri qtikaʼ	qum, a.k.a.
#qum# Escuela	Ri wxqʼajlobʼ tarnuul chwij mi compañero viene atrás	qum xkʼoʼl ri rwiʼy ri rkaʼy
#qum# La mujer muele la pepita de ayote en la piedra de moler	Ri ixoq kirjokʼ ri skiil chu kaʼ	qum qal ri xkʼolik ri rkʼolik ri rchʼiy
#qum# El ajenjo es bueno para el dolor de estómago	Wu musmut utz chi qʼxom kʼuʼxaj	qumilil
#qum# Mi abuel o posee grandes conocimientos	Ri n tatanool nim ri retambʼal	qum xwiʼ riij xtzʼoʼj
#qum# Escama	Don Jesus se puso la camisa al revés	qum ri rqʼoʼj ri ajkʼal ri rkaʼyik
#qum# Pagar	Ri toch ʼaʼ kirtij ri rwoch nuxtaʼ el jilguero c ome la fruta de la tuna	qum ri achii xbʼiij ri rʼiʼj
#qum# el árbol es frondoso y da buena sombra	Ri cheʼ pujpik sichaʼ kiryaʼ muʼj	qum, i'm a flowering tree.
#qum# Cuando construí mi casa tuve que hacer un préstamo	ataq xinbʼan ri wchoch xinbʼan jun jloom	qum, i had to borrow for myself.
#qum# La comadreja tiene la cola larga	Ri saqtbʼiin jurjik wu rjey	qum, i.e.
#qum# Por mucha carga el carro no aguantó salir en la subida	Kʼa xaq et rchim wu chʼiichʼ xichaʼ qal xchʼij xelbʼik chu wu rujyubʼ	qum, i.e. because of the amount of cargo that the load had, the carriage could not leave the mountain
#qum# El trabajo que hace la mujer todos los	Ri rchak ri ixoq kirbʼan njeel qʼiij areʼ ri tʼisneem	qum xkʼulik ri xkʼolik
#qum# La tosferina le da a los niños	Wu jiiqʼ kiryaʼ che ri ajkʼalobʼ	qum ri rchʼiy xkʼabʼal ri rxwiʼ
#qum# La señorita se ve elegante con sus collares	Ri aliit qʼus rkaʼyxik kukʼ ri ruwaj	"qum. ""Kahen"" ""kahen"" ""kahen"" ""kahen"""
#qum# Cuando terminó la	Ataq xkʼisik ri molbʼeem ri aloʼm xiʼ tikrook chu ktzʼulxik ri altom	qum ri alaabʼ xkʼiij
#qum# La chicharra de pino tambien se usa	Wu chʼikaʼx xuqkee kchuknik chi siʼ	qum ri rchʼiʼtxik ri rbʼan
#qum# Semana	En el techo de la casa hay dos agujeros	qum ri rchʼiʼbʼanik ri rchʼiʼ
#qum# El trabajo quedó mal hecho por eso se	Ri chaak xaq che rbʼ anik sic haʼ xqtzuntzaj	qum ixoxxxxxxxxxxxxxxxxxxxxxxxxxxxxxxxxxxxxxxxxxxxxxxxxxxxxxxxxxxxxxxxxxxxxx
#qum# El hombre salió temprano a sembrar la	Aqʼabʼ xelbʼik ri achii chi rawxik ri chnooj	qummmmmmmmmmmmmmmmmmmmmmmmmmmmmmmmmmmmmmmmmmmmmmmmmmmmmmmmmmmmmmmmmmmmmmmmmmmmmmmmmmmmmmmmmmmmmmmmmmmmmmmmmmmmmmmmmmmmmmmmmmmmmmmmmmmmmmmmmmmmmmmmmmmmmmmmmmmmmmmmmmmmmmmmmmmmmmmmmmmmmmmmmmmm .
#qum# Hay mucho miedo al asesino Ciprés	Xibʼal xibʼaliibʼ chu ri wiʼtnel	qum ri chʼoʼchʼ ri chʼiʼj
#qum# a la señora se le quemó la piel de la mano	X kʼatik ri rtzʼumil rqʼabʼ ri ixoq	qum. The woman has burned her skin in her hand.
#qum# Cuanto ascendió la cantidad del dinero	Jrubʼ rajlaal ri poq xeʼloq	qum r rkʼaʼ ri rchʼik ri rchʼiʼj
#qum# Ya no hay venta porque se murió el dueño Bellota de arboles	Qaqchee chik ri k ʼ yeej kumu xchupik ri rxoqʼjowil	qum ri chaʼ riij chʼuʼj
#qum# La mujer fue a buscar hongo en la	Ri ixoq xbʼeek chi rtaqxik qʼaʼtzuy praal cheʼ	qumsaxbʼelʼeʼlʼtʼoʼn
#qum# De día ent raron los ladrones en la casa a robar	Paqʼiij xoʼkik ri elqʼoom pjaay elqʼnel	qumqumqumqumqumqumqumqumqumqumqumqumqumqumqumqumqumqumqum
#qum# Nuestro camino se	Ri qbʼey xsukʼbʼik kumu xqjnumsaj ri qchoqʼaabʼ	qum xkʼulik ri rchʼiʼj
#qum# C uando cayó el niño le salió sangre en la nariz	Ataq xtzaqik ri ajkʼaal xelul kikʼ pirtzaʼm	qum, i'm gonna have to go.
#qum# El retrato es algo que nos recuerda	Ri wochbʼlaal areʼ jun naʼtbʼal qe	qumilil riij xbʼajbʼal
#qum# Cuando hay mucho aire el techo de la casa	Ataq xi bʼal kqʼiiqʼ ri rwiʼ jaay ktzalbʼik	qum, i.e. the roof of the house
#qum# La cria de la oveja lo amamantan porque	Ri raal chiij ktuʼnsxik kumu qal xpon rqʼij	qumilike
#qum# El gato de monte se comió todos los pollitos	Ri yaak xeʼrtij ri raa l akʼ	qumokokomookamookamookamookamookamookamoamoochamoozamoochamoochamoozamaochama
#qum# La	Ri rkʼoʼxiil ubʼooy kchuknik chu awbʼal	qum ri rbʼey ri rbʼanik ri rxʼiʼj
#qum# A la muchach a no se le nota que es tartamuda	Ri aliit qal kirkʼut saqsi tzʼeebʼ	qum. The girl doesn't realize she's dead.
#qum# El hombre mató el venado con su	Ri achii xrubʼaaj ri musaat rukʼ ri ubʼ al	qum i i i i i i i i i i i i i i i i i i i i i i i i i i i i i
#qum# la puerta de la casa se partió por el temblor	Ri rchiʼ jaay xpaqʼtjik rum ri rkabʼ rqan	qumile.
#qum# Mi hernana tiene gemelos	Ri wnobʼ yuux ri raal	qum ri kʼolik ri rkaʼyxik ri chʼool
#qum# Al perro le dio fiebre	Ri tzʼiʼ xelul qʼaaqʼ chriij	qum ri chʼiichʼ ri rchʼoʼq
#qum# El anciano ya no aguanta afeitarse	Ri tatyoox qal chik kirchʼij rjoʼxik ri rsomchiʼ	qumse. The old man can't scratch himself anymore.
#qum# Todos los trabajadores les pusieron a	Njeel ri ajchaak xeʼyoʼqook chu rpaqʼik ri uleew	qum xkʼoʼj ri rchʼoj ri rchʼul
#qum# T odos los trabajadores ayudaron para juntar la	Njeel ri ajchaak xeʼtobʼik chu rmolik ri abʼaj	qumqʼiʼl riij xkʼuʼn
#qum# La tierra se tiene que compactar bien	Wu ulee w naʼl xtzʼaqik	qum ri rkaʼj ri rchʼool ri rchʼak
#qum# El gato le dió un mordisco al pan	Ri wix kir qchʼuj ri paan	qum xeʼ ri rkʼaʼ ri rbʼeem
#qum# Cerrado	Ataq xojelbʼik qonjeel x qtzʼap ijken ri rchiʼ jaay	qum ri rkaʼyʼyxik ri rchʼiʼj
#qum# El bastó n de mi abuelo se quebró	Ri rchʼmeʼy ntatanool xq ʼajik	qum ri rkʼoʼ ri rchchʼal
#qum# La hamaca está hecha de pita de mecate	Ri abʼaʼ bʼantlik rukʼ saqkiiy	qum ri rchʼiʼ
#qum# ¿cuándo?	¿Cuánto cuesta el sombrero que compró mi mamá en la plaza	qum ri rkaʼyik ri rchʼiʼj
#qum# El hombre salió con su perro a cazar	R i achii xelbʼik rukʼ ri rtzʼiʼ chu rtaqxik ri musaat	qum xbʼiij ri ajkʼiij
#qum# El ratón ensuscio todo el maíz fracción/ pedazo	Ri chʼooy xchʼulchʼaʼ ri ixiim	qum xbʼiʼ ri rchʼiʼj
#qum# Toda la gente tienen buena ineligencia por eso están bien	Njeel ri wnaq nim ri knoʼj sichaʼ utz ikʼolik	qum, i. All men have a good inequality, so they are good
#qum# Mi mamá tuvo que	Ri nchuch xtzaltzaj ri poʼt ri xloqʼ kumu nuchʼ xkanaj chriij	qumobʼ jtzʼal ri rʼiʼl
#qum# La Guayaba se da en los barrancos	Ri keqʼ kiryaʼ ptaq ri rqan swon	qum ri rxʼabʼ ri rbʼal ri rbʼanik
#qum# Los c erdos ensuciaron la comida	Ri kuch xkchʼulchʼaʼ ri kwoy	qum kʼoʼj riij
#qum# Bejuquillo	Cuando oímos el río tumbar rápido corrimos	qum ri rkʼiʼqʼiij ri rbʼanik
#qum# Hoy va llover con granizo	Ajwiʼ xtpetik jabʼ rukʼ saqbʼuch	qum kiryaʼ ri xtzʼolik ri rbʼan
#qum# El perro se revolcaron con el coyote	Ri tzʼiʼ xkbʼalktij kiibʼ rukʼ ri sjiʼl	qum rkaʼ ri chʼoʼn
#qum# Es necesario cuando amanecemos debemos agradecer a Dios	Riliil riij ataq xkojwaʼljik xkojtyoxnik chu Ajaw	qum, i.e. i.e. i.e. i.e. i.e. i.e. i.e. i.e.e.e
#qum# Me duele el oído	Kqʼoxwik ri nxkin	qum. I'm sick of the ear.
#qum# Mi perro está acostumbrado comer chile	Ri ntzʼiʼ naqʼtlik kirtij iik	qumeh. . . . . . . . . . . . . . . . . . . . . . . . . . . . . . . . . . . . . . . . . . . . . . . . . . . . . . . . . . . . . . . . . . . . . . . . . . . . . . . . . . . . . . . . . . . . . . . . . . . . . . . . . . . . . . . . . . . . . . . . . . . . . . . . . . . . . . . . . . . . . . . . . . . . . . . . . . . . . . . . . . . . . . . . . . . . . . . . . . . . . . . . . . . . . . . . . . . . .
#qum# En los barrancos se da mucho el helecho	Ptaq ri rqan swon kiryaʼ xibʼal ri chibʼaʼ	qum wu rchʼiyikʼ ri rkaʼyxik
#qum# El sastre fue matado por los ladrones	R i ajtʼisnel xwiʼtxik kum ri elqʼoom	qumilill cheʼeʼl cheʼn chʼoʼnchʼ chʼuʼchʼuʼ
#qum# El maestro dice a los estudiantes que guarden	Ri ajtiij xbʼ iij chke ri ajtijnel kʼotz kixkʼ olaq	qum.
#qum# Cuando le fueron a encontrar a la mujer la	Ataq xeʼriqtjaq ri ixoq juplik bʼanmajken chre	qum, i.e. when the blade was put on
#qum# Camarón	La orina apesta mucho cuando hay mucho calor	qum ri ajkʼabʼ ri rkʼoʼl ri rchʼuʼ
#qum# Mucha diversión se hizo en el parque	Nim ri kaʼy kbʼanik chu ri waʼktbʼal	qum. He had a lot of fun in the park.
#qum# El regaño es bueno enseñarles a los niños	Ri yaaj utz xttijxik chke ri ajkʼlobʼ	qum wu rchʼiʼj xbʼanik
#qum# La ardilla se terminó de comer los elotes	Wu kuuk xkʼis ri a j chtijik	qum xʼajik ri xbʼal ri rkʼoʼn
